這個檔整理常見的詞彙。
注意前面有 # 的是表示尚未確定，或是有聽過這樣的用法。

add: 加入
address book: 通訊錄
alarm: 警告
alert: 警示
anonymous: 匿名
appear: 顯示
appearance: 外觀
aspect: 外觀
authentication: 驗證
authority: 授權
back: 往後
background: 背景
blank: 空白
block: 區塊
bookmark: 書籤
button: 按鈕  
CA: 認證中心
CA certificate: CA 憑證
CA Root: 最高層認證中心
cache: 快取
Calendar: 行事曆
category: 類別
caption: 題要
caution: 警告
certificate: 憑證
certificate authority: 認證中心
certificate backup password: 憑證備份密碼
certificate-based authentication: 基於憑證的驗證
certificate chain: 憑證鏈結
certificate fingerprint: 憑證指紋
Certificate Manager: 憑證管理員
certificate renewal: 憑證更換
certificate revocation list: 憑證廢止清單
certificate verification: 憑證確認
change: 改變 or 變更
character: 字元
character code: 字元編碼
characterset: 字元集
checkbox: 勾選盒
clear: 清除
click: 點選 or 按下
client: 客戶端
client authentication: 客戶端驗證
client SSL certificate: 客戶端 SSL 憑證
color: 色彩
Component: 元件
Component Bar: 元件列
compose: 編輯器
composer: 設計師
content: 內容
cookie: cookie
Cookie Manager: Cookie 管理員
copy: 複製
cryptographic algorithm: 密碼演算法
cryptography: 密碼學
decryption: 解密
default: (名詞)預設值
default: (形容詞)預設的
delete: 刪除
Device Manager: 裝置管理員
dialog box: 對話盒
digital ID: 數位 ID
digital signature: 數位簽署
distinguished name: 識別名稱
drop-down: 下拉
dual key pairs: 複式金鑰
eavesdropping: 竊聽
edit: 編輯
encryption: 加密
encryption certificate: 加密憑證
encryption key: 加密金鑰
existing: 現有
expand: 展開
Extensible Stylesheet Language Transformation:  延伸樣式語言轉換
Extensible Markup Language:  延伸標示語言
Extension: 擴充套件 (currently used in MozillaFirebird)
file: 檔案
File Transfer Protocol: 檔案傳輸協定
filter: 過濾器
fingerprint: 指紋
font: 字型
foreign cookie: 第三者 cookie
Form Manager: 表單管理員
forward: 往前
FTP: 檔案傳輸協定
go: 衝 (thanks to kcwu)
group: 群組
helper application: 輔助程式
header(mail): 欄位標題
heading: 段落標題
history: 記錄
flag: 旗標 or 標註
home page: 首頁
homepage: 首頁
host: 主機
icon: 圖示
identify: 證明
ignore: 忽略
implement: 執行
implicit consent: 默認
incorporate: 結合
information: 資訊
install: 安裝
interactive: 交互作用
intercept: 中途攔截
interface: 介面
intermediate CA: 中級認證中心
Internet: 網際網路
internet identity: 網際證明
Internet Message Access Protocol: 網際訊息存取通訊協定
Internet protocol address: 網際通訊協定位址
IP: IP
IP address: IP 位址
issuer: 發行者
key: 金鑰
keyword: 關鍵字
language: 語言
Lightweight Directory Access Protocol: 簡易資料通訊協定
link: 鏈結
list: (名詞)列表
list: (動詞)列出
Location Bar: 位址列/網址列
low-grade: 低階
Manage Certificate: 管理憑證
Manage Security Device: 管理安全性裝置
master key: 主金鑰
master password: 主密碼
menu: 選單
message: 訊息
misrepresentation: 詐稱
mouse: 滑鼠
mouse wheel: 滑鼠滾輪
move down: 下移
move up: 上移
Navigation Toolbar: 導航工具列 or 瀏覽工具列
navigate: 瀏覽
navigator: 瀏覽器
news: 新聞
newsgroup: 新聞群組
nightly build: 最新測試版 (?)
object signing: 物件簽署
object signing certificate: 物件簽署憑證
OCSP: 線上憑證狀態通訊協定
Online Certificate Status Protocol: 線上憑證狀態通訊協定
open: 開啟
Organization: 組織
Organization Unit: 組織單位
pack: 封包
panel: 面板
password-based authentication: 根據密碼的驗證
Password Manager: 密碼管理員
password quality meter: 密碼品質量尺
Personal Toolbar: 自訂工具列
PFS: 外掛尋找服務
picture: 圖片
pipelining: 管線流通
PKCS #11: PKCS #11
PKCS #11 module: PKCS #11 模組
PKI: 公開金鑰基礎建設
Platform for Privacy Preferences: 隱私偏好平台
plug-in: (外掛[模組]) or 直接叫 Plugin
plugin finder service: 外掛尋找服務
POP: 郵局通訊協定
Post Office Protocol: 郵局通訊協定
preference: (個人)偏好設定
print: 列印
print plus: 預覽列印
privacy: 隱私
privacy & security: 隱私和安全性
private key: 私密金鑰
profile: 定義檔
Profile Manager: 定義檔管理員
proxy: 代理
public key: 公開金鑰
public-key cryptography: 公開金鑰密碼學
public-key infrastructure: 公開金鑰基礎建設
quit: 結束
remove: 移除
reset: 重設
resolution: 解析度
response: 回應
response signer: 回應簽署
Response Signer Certificate: 回應簽署憑證
retrace: 追溯
Return to beginning of section: 回到上方的選單
root CA: 最高憑證管理中心
release: 官方發行版 or 正式發行版
release notes: 版本資訊
save: 儲存
screen: 螢幕
script: 描述語言程式
Secure Sockets Layer: 安全連線通訊層(SSL)
security: 安全性
security certificate: 安全性憑證
security device: 安全性憑證
security module: 安全性模組
security token: 安全性符號
see: 請觀看
select: 選取 or 選擇
server: 伺服器
server authentication: 伺服器驗證
server SSL certificate: 伺服器 SSL 憑證
set: 設定
setting: 設定
shortcuts: 快速鍵
show: 顯示
signing certificate: 簽署憑證
signing key: 簽署金鑰
sidebar: 資訊方塊列
slot: 擴充槽
smart card: 智慧卡
software: 軟體
software security device: 軟體安全性裝置
SSL: 安全連線通訊層(Security Socket Layer)
start up: 啟動
Status: 狀態
Status Bar: 狀態列
step-to-step: 步驟
subcategory: 子類別
subject: 主題
subordinate CA: 次級認證中心
symmetric encryption: 對稱加密
system: 系統
system administrator: 系統管理員
tab: 分頁
tabbed: 分頁
talkback: 回報
tamper detection: 竄改偵測
task: 工作
TCP: TCP
term: 術語
text: 文字
the Web: 網路
theme: 佈景主題
throbber:  跳動視窗圖示
Third-party cookie: 第三者 cookie
title: 標題
TLS: 傳輸層安全性
TLS intolerant: 與傳輸層安全性不相容
token: 符號
tool: 工具
toolbar: 工具列
tooltip: 工具提示
Transmission Control Protocol/Internet Protocol:  傳輸控制協定/網際網路協定 
Transport Layer Security: 傳輸層安全性
trust: 信任
Type Aheaed Find: 隨打即找 (by jwbai)
underline: 底線
Uniform Resource Locator: 統一資源定址器
uninstall: 解除安裝
unload: 卸載
URL: 網址 or URL
user: 用戶
validation: 有效 or 驗證
verification: 鑑定 or 確認
view(chatzilla): 分頁 (like tab)
web site: 網站
World Wide Web: 全球資訊網

---
下面是有人這樣用，但目前採直接用英文不翻的詞：
XML:  延伸標示語言
XSLT:  延伸樣式語言轉換
HTML: 超文件標示語言
HTTP: 超文件傳輸協定
Hypertext Markup Language: 超文件標示語言
Hypertext Transport Protocol: 超文件傳輸協定
IMAP: 網際訊息存取通訊協定
Java: 爪哇
JavaScript: 爪哇描述語言
LDAP: 簡易資料通訊協定
Netscape: 網景
Netscape Quality Feedback Agent: 網景品質回饋代理
spoofing: 愚弄
subject name: 實體名稱
nonrepudiation: 不否認
FIPS PUBS 140-1: 聯邦資訊處理標準發行 140-1 號
cipher: 密碼檢索表
